#
# 0 E room0.txt 2
#
WWWW0WWWWW
W        W
W        W
W        W
W        W
W        W
W        W
W        W
W        W
WWWWWWWWWW
