#
# 0 D room0.txt 1 key1
# 1 D room0.txt 0
#
# k key1
#
WWWWWWWWWW
WS   G   W
W        W
W     k sW
W        W
W      W W
W    B W W
W  WWWWW W
0  W     W
WWWW1WWWWW
